1;1,0;18,1;1
1;1,0;18,1;1
1;1,0;18,1;1
1;1,0;18,1;1
1;1,0;14,1;6
1;1,0;18,1;1
1;1,0;18,1;1
1;1,0;17,2;1,0;1
1;1,0;18,1;1
1;1,0;18,1;1
1;1,0;12,1;7
1;1,0;18,1;1
1;9,0;8,1;1
1;1,0;18,1;1
1;1,0;18,1;1
1;10,0;10,1;10