1;1,18,1;6,14,1;1,18,1;
1;1,18,1;6,14,1;1,18,1;
1;1,18,1;6,14,1;1,18,1;
1;1,18,1;6,14,1;1,18,1;
1;1,14,0;6,1,1;1,6,0;1,1,1;1,18,1;
1;1,18,1;6,14,1;1,18,1;
1;1,18,1;6,14,1;1,18,1;
1;1,17,0;1,2,1;16,1,0;2,1,1;
1;1,18,1;6,14,1;1,18,1;
1;1,18,1;6,14,1;1,18,1;
1;1,12,0;7,1,1;
1;1,18,1;6,14,1;
1,9;8,1;1,18,1;
1;1,18,1;6,14,1;1,18,1;
1;1,18,1;6,14,1;1,18,1;
1;1,42;